XXXXXXXXXXXXXXX
XPX  XXXXXX   X
X X X     X X X
X X   XXX X X X
X XXX XX  X X X
X   X  X XX X X
XXX XX X X  X X
X X  X X X  X X
X X    X X  X X
X XGXXXX X  X X
X X X    X  X X
X X      X  X X
X X  XXXXX  X X
X           XEX
XXXXXXXXXXXXXXX