   ##### #  ###
 #     # ## #  
  ## #   #    #
#   ####   ####
   #     ###  #
## #### ##   ##
   ###    #####
 #   ## # ##  #
 ## #   #   ###
###  #### #####
### ## #  ##  #
#   #  # ##  ##
  ##  #     ###
##### ## ## ###
#    ###  #    